1111111111111111
100K000H000K0001
1EEEEEEBEEEEEEE1
1000000000000001
1002000000020001
1003000C00030001
1000000000000001
100C000C000C0001
1000000000000001
1000000000000001
1002000C00020001
1003000200030001
100K0003000K0001
100K0000000K0001
1000000200000001
1222000300002221
1333000C00003331
1000000000000001
100C000C000C0001
1000000000000001
1000000000000001
1002000C00020001
1003000200030001
100K0003000K0001
1000000000000001
10000P0000000001
1111111111111111